10
..........
xx........
xxx.......
.xxx......
..xx......
..xx......
.xxx......
.xx.......
.xxxx.....
..xxxx....
